














































